********************************
********************************
*************************d******
*******xxxxxxixxxxxxxxxxxx******
******xxxxxxxixxxxiiixxxxxx*****
*****xxxxqxxxixxxxExxpxxxxxx****
*************************|******
***xxxxxxxxxxxxxxxxxxxxxx|******
****Pxxxxxxxxxxxxxxxxxxxx|xxx***
*****xxxxxxxxxxxxxxxxxxxxxxxx***
******SSSpSSSiSSSpSSSiSSSpSSS***
********************************
********************************
********************************
