**************************
**************************
**************************
**************f***********
**************************
*****xxxx**xxxxpxxxxxx****
****xxxPx*xxqxxpxxxxx@x***
****xxx************|******
***xxdx************|******
***xxxxxxxxxxxixxxx|******
***xxxxxxxxxxxiXxxx|xxx***
***xxXxxxxxxxxixxxxxxxx***
*******SSSSiSSSSSSS*******
**************************
**************************
**************************